100 100
1011101110111011101110111111011101110111011101111110111011101110111011101111110111011101110111011101
1110111011101110111011111101110111011101110111011011101110111011101110111111011101110111011101110111
1011101110111011101110111111011101110111011101110110111011101110111011101111110111011101110111011101
1110111011101110111011111101110111011101110111011011101110111011101110111111011101110111011101110111
1011101110111011101110111111011101110111011101110110111011101110111011101111110111011101110111011101
1110111011101110111011111101110111011101110111011011101110111011101110111111011101110111011101110111
1011101110111011101110111111011101110111011101110110111011101110111011101111110111011101110111011101
1110111011101110111011111101110111011101110111011011101110111011101110111111011101110111011101110111
1011101110111011101110111111011101110111011101110110111011101110111011101111110111011101110111011101
1110111011101110111011111101110111011101110111011011101110111011101110111111011101110111011101110111
1011101110111011101110111111011101110111011101110110111011101110111011101111110111011101110111011101
1110111011101110111011111101110111011101110111011011101110111011101110111111011101110111011101110111
1011101110111011101110111111011101110111011101110110111011101110111011101111110111011101110111011101
1110111011101110111011111101110111011101110111011011101110111011101110111111011101110111011101110111
1011101110111011101110111111011101110111011101110110111011101110111011101111110111011101110111011101
1110111011101110111011111101110111011101110111011011101110111011101110111111011101110111011101110111
1011101110111011101110111111011101110111011101110110111011101110111011101111110111011101110111011101
1110111011101110111011111101110111011101110111011011101110111011101110111111011101110111011101110111
1011101110111011101110111111011101110111011101110110111011101110111011101111110111011101110111011101
1110111011101110111011111101110111011101110111011011101110111011101110111111011101110111011101110111
1011101110111011101110111111011101110111011101110110111011101110111011101111110111011101110111011101
1110111011101110111011111101110111011101110111011011101110111011101110111111011101110111011101110111
1011101110111011101110111111011101110111011101110110111011101110111011101111110111011101110111011101
1110111011101110111011111101110111011101110111011011101110111011101110111111011101110111011101110111
1011101110111011101110111111011101110111011101110110111011101110111011101111110111011101110111011101
1110111011101110111011111101110111011101110111011011101110111011101110111111011101110111011101110111
1011101110111011101110111111011101110111011101110110111011101110111011101111110111011101110111011101
1110111011101110111011111101110111011101110111011011101110111011101110111111011101110111011101110111
1011101110111011101110111111011101110111011101110110111011101110111011101111110111011101110111011101
1110111011101110111011111101110111011101110111011011101110111011101110111111011101110111011101110111
1011101110111011101110111111011101110111011101110110111011101110111011101111110111011101110111011101
1110111011101110111011111101110111011101110111011011101110111011101110111111011101110111011101110111
1011101110111011101110111111011101110111011101110110111011101110111011101111110111011101110111011101
1110111011101110111011111101110111011101110111011011101110111011101110111111011101110111011101110111
1011101110111011101110111111011101110111011101110110111011101110111011101111110111011101110111011101
1110111011101110111011111101110111011101110111011011101110111011101110111111011101110111011101110111
1011101110111011101110111111011101110111011101110110111011101110111011101111110111011101110111011101
1110111011101110111011111101110111011101110111011011101110111011101110111111011101110111011101110111
1011101110111011101110111111011101110111011101110110111011101110111011101111110111011101110111011101
1110111011101110111011111101110111011101110111011011101110111011101110111111011101110111011101110111
1011101110111011101110111111011101110111011101110110111011101110111011101111110111011101110111011101
1110111011101110111011111101110111011101110111011011101110111011101110111111011101110111011101110111
1011101110111011101110111111011101110111011101110110111011101110111011101111110111011101110111011101
1110111011101110111011111101110111011101110111011011101110111011101110111111011101110111011101110111
1011101110111011101110111111011101110111011101110110111011101110111011101111110111011101110111011101
1110111011101110111011111101110111011101110111011011101110111011101110111111011101110111011101110111
1011101110111011101110111111011101110111011101110110111011101110111011101111110111011101110111011101
1110111011101110111011111101110111011101110111011011101110111011101110111111011101110111011101110111
1011101110111011101110111111011101110111011101110110111011101110111011101111110111011101110111011101
1110111011101110111011111101110111011101110111011011101110111011101110111111011101110111011101110111
1011101110111011101110111111011101110111011101110110111011101110111011101111110111011101110111011101
1110111011101110111011111101110111011101110111011011101110111011101110111111011101110111011101110111
1011101110111011101110111111011101110111011101110110111011101110111011101111110111011101110111011101
1110111011101110111011111101110111011101110111011011101110111011101110111111011101110111011101110111
1011101110111011101110111111011101110111011101110110111011101110111011101111110111011101110111011101
1110111011101110111011111101110111011101110111011011101110111011101110111111011101110111011101110111
1011101110111011101110111111011101110111011101110110111011101110111011101111110111011101110111011101
1110111011101110111011111101110111011101110111011011101110111011101110111111011101110111011101110111
1011101110111011101110111111011101110111011101110110111011101110111011101111110111011101110111011101
1110111011101110111011111101110111011101110111011011101110111011101110111111011101110111011101110111
1011101110111011101110111111011101110111011101110110111011101110111011101111110111011101110111011101
1110111011101110111011111101110111011101110111011011101110111011101110111111011101110111011101110111
1011101110111011101110111111011101110111011101110110111011101110111011101111110111011101110111011101
1110111011101110111011111101110111011101110111011011101110111011101110111111011101110111011101110111
1011101110111011101110111111011101110111011101110110111011101110111011101111110111011101110111011101
1110111011101110111011111101110111011101110111011011101110111011101110111111011101110111011101110111
1011101110111011101110111111011101110111011101110110111011101110111011101111110111011101110111011101
1110111011101110111011111101110111011101110111011011101110111011101110111111011101110111011101110111
1011101110111011101110111111011101110111011101110110111011101110111011101111110111011101110111011101
1110111011101110111011111101110111011101110111011011101110111011101110111111011101110111011101110111
1011101110111011101110111111011101110111011101110110111011101110111011101111110111011101110111011101
1110111011101110111011111101110111011101110111011011101110111011101110111111011101110111011101110111
1011101110111011101110111111011101110111011101110110111011101110111011101111110111011101110111011101
1110111011101110111011111101110111011101110111011011101110111011101110111111011101110111011101110111
1011101110111011101110111111011101110111011101110110111011101110111011101111110111011101110111011101
1110111011101110111011111101110111011101110111011011101110111011101110111111011101110111011101110111
1011101110111011101110111111011101110111011101110110111011101110111011101111110111011101110111011101
1110111011101110111011111101110111011101110111011011101110111011101110111111011101110111011101110111
1011101110111011101110111111011101110111011101110110111011101110111011101111110111011101110111011101
1110111011101110111011111101110111011101110111011011101110111011101110111111011101110111011101110111
1011101110111011101110111111011101110111011101110110111011101110111011101111110111011101110111011101
1110111011101110111011111101110111011101110111011011101110111011101110111111011101110111011101110111
1011101110111011101110111111011101110111011101110110111011101110111011101111110111011101110111011101
1110111011101110111011111101110111011101110111011011101110111011101110111111011101110111011101110111
1011101110111011101110111111011101110111011101110110111011101110111011101111110111011101110111011101
1110111011101110111011111101110111011101110111011011101110111011101110111111011101110111011101110111
1011101110111011101110111111011101110111011101110110111011101110111011101111110111011101110111011101
1110111011101110111011111101110111011101110111011011101110111011101110111111011101110111011101110111
1011101110111011101110111111011101110111011101110110111011101110111011101111110111011101110111011101
1110111011101110111011111101110111011101110111011011101110111011101110111111011101110111011101110111
1011101110111011101110111111011101110111011101110110111011101110111011101111110111011101110111011101
1110111011101110111011111101110111011101110111011011101110111011101110111111011101110111011101110111
1011101110111011101110111111011101110111011101110110111011101110111011101111110111011101110111011101
1110111011101110111011111101110111011101110111011011101110111011101110111111011101110111011101110111
1011101110111011101110111111011101110111011101110110111011101110111011101111110111011101110111011101
1110111011101110111011111101110111011101110111011011101110111011101110111111011101110111011101110111
1011101110111011101110111111011101110111011101110110111011101110111011101111110111011101110111011101
1110111011101110111011111101110111011101110111011011101110111011101110111111011101110111011101110111
1011101110111011101110111111011101110111011101110110111011101110111011101111110111011101110111011101
1110111011101110111011111101110111011101110111011011101110111011101110111111011101110111011101110111